222222222222222
200010010100002
202021212121202
201110110111102
212121212121212
201110110111112
212121212021212
211101111111012
212021202021212
201111101101102
202021212120202
200011111110002
222222222222222