222222222222222
200001111110002
202121202021202
200001101111102
212121202121202
211010111111002
212121202121212
211111111111112
212021212120212
201110011110002
202121212121202
200011011110002
222222222222222