222222222222222
200001001110002
202020212121202
201111111011102
212121212021212
201110010111012
212121202121212
211111110111112
212121202021212
201011101111102
202021212121202
200010110110002
222222222222222